NO ./textures/bricks.xpm
SO ./textures/wood.xpm
WE ./textures/gold.xpm
EA ./textures/wall.xpm
C 200,100,50
F 50,100,200
                                                                                                     
  11111111111111111111                                                                               
  10000000000000000001       111111111111
  10000000000000000001       100000000001
  10000000000000000001       100000N00001
  10000000000000000001       100000000001
  11111000000000000001       111011111111
      1000000000000001         101           
      1000000000000001         101           
      100000000000000111111111110111111111   
      100000000000000000000000000000000001   
      111111111111111111111111111111111101   
                                       101   
                                       101   
                                       101   
                11111111111111         101   
                1            1         101   
                1            1         101   
                11111111111111         101   
                                       101   
111111111111111111111111111111111111111101
100000000000000000000000000000000000000001
100110011001100110011001100110011001111111
100110011001100110011001100110011000
100000000000000000000000000000000001
111111111111111111111111111111111111
