NO ./textures/bricks.xpm
SO ./textures/wood.xpm
WE ./textures/gold.xpm
EA ./textures/wall.xpm
C 200,100,50
F 50,100,200

111111111
11     11
11 000 11
11 0N0 11
11 000 11
11     11
111111111
