NO ./textures/bricks.xpm
SO ./textures/wood.xpm
WE ./textures/gold.xpm
EA ./textures/wall.xpm
C 1234,100,50
F -768,100,200

11111
10001
10N01
10001
11111
