NO ./textures/bricks.xpm
SO ./textures/wood.xpm
WE ./textures/gold.xpm
EA ./textures/wall.xpm
C 200,100,50
F 50,100,200

1111111111111111
1100010000100011
1010100000010101
1101000000001011
1010000S00000101
1001000000001001
1010100000010101
1100010000100011
1111111111111111
